# 1 lesson
acquaintance - знайомство
collaborative - спільний,злагоджений
collaborate with sb - співпрацювати з кимось
workaholic - залежний від роблти
multitasker - багатозадачний
yes man - чувак який зі всім згіден
job satisfaction - задоволення від роботи
associate/colleague - колега
entrepreneur - підприємець
to expand - розширювати
founder - засновник
funding - фінансування
to create/ to generate - створювати
impromptu/ on the spot - імпровізований
internet savvy - підкований в Інтернеті
to launch - організувати, запустити
to pay off - винагородити, окупитись
be skilful at doing sth - бути знавцем, бути вмілим в чомусь
apprentice - новачок, початківець
trainee - стажер
be self - employed - працювати на себе
call it a day - закінчити роботу на сьогодні
to be in charge - керувати
get the sack/ to be fired - бути звільненим
be promoted - отримати підвищення
exhausting - виснажливий
stale - банальний, застарілий
manual work - ручна, фізична робота
mind - numbing - дуже нудний, монотонний
persistence - наполегливість
to persist - наполягати
show sb the ropes - пояснювати комусь як щось працює
have flexi - time, have flexible hours - гнучкий графік роботи
workload - робоче навантаження
workmate - співробітник
unaccustomed to sth - незвиклий до чогось
uncommon - незвичний
unfamiliar - незнайомий
to take a chance on sth - скористатись шансом
hit the books - наполегливо вчитись
keep the pace with - йти в ногу з чимось, не відставати
call the shots - приймати рішення
adventure - пригода
efforts - efforts
uncanny - дивовижний
hand in my notice - вручити моє повідомлення
employment exchange - біржа
labour exchange - біржа
further training -  підвищення кваліфікації
human resources - пересонал
job appointment - призначення
obliviously - очивеидно
labour code - трудовий кодекс

# 2 lesson
slippery slope - стати на слизьку дорогу, небезпечна справа
a conspiracy - таємна організація, змова
run the world - керувати світом
invisible - невидимий
intercept - перехопити /завадити
to blackmail - шантажувати
break the law - порушити закон
the threat - загроза
to flee - зникнути, втекти
sysadmin - системний адміністратор
wipe - стирати
the higher - ups - начальство
high - strung - напружений, нервовий
devastated - спустошений, пригнічений
to bug - не давати спокою, дратувати
to yell - кричати
counterfeit - підробка
hoax - обман розіграш
insight - проникливість
rigged - сфальсифіковані
sedated - заспокійливий
to pretend - притворятися
coward - боягуз
frustrated - розчарований , розбитий
delusion - ілюзія, галюцинація
be on good terms - бути в хороших відносинах з кимось
awkward - незграбний
for one’s sake - заради когось, на благо
to justify - виправдати , обгрунтувати
to witness - засвідчити, бути свідком чогось
infidelity - недостовірність, неточність, зрада
literally -  буквально
evil - зло
pop up - появлятися
a moron - кретин
arrogant - зухвалий
humble - простий
can’t hold in sth - не витримувати
purity - правильність, чистота
maintenance - обслуговування, утримання
spare change - дрібні гроші
revenue - дохід
to reboot - перезапустити
malicious - зловмисний
replicate - продублювати
boot - up - запустити
the jet - літак
the boot sequence - порядок завантаження
up and running - налагоджений, в робочому стані, запущений
petty thief - кишеньковий злодій
hold down a job - намагатись втриматись за роботу
to rob - грабувати
convenience stores - цілодобовий магазин
small - time stuff - дрібниці
get bamboozled - бути обманутим
a jail - в язниця
schizo - псих
get rid of sth - позбутися чогось
be on the verge - бути на межі.., бути готовим щось зробити
entrenched - закоренілий
to reinforce - посилити, закріпити
limb by limb - по кусочках
unravel - розплутати, розгадати
to take my mind off sth– відволіктись від чогось
to verify - перевіряти
intact - цілий, непошкоджений
a proclivity - схильність тенденція
nepotism - призначення або просування по службі на основі родинних зв'язків
odd jobs - різна, випадкова робота
off - hour job - робота за сумісництвом
out of job, between jobs - без роботи
flexible hours (flexitime брит., flextime амер.) - змінний графік
full time job - неповний робочий день
part time job - неповна зайнятість, неповний робочий день
personnel department - відділ кадрів
blue collar job - робота безпосередньо пов'язана з виробництвом матеріальних благ
pink collar job - робота в сфері обслуговування, традиційно виконувалася жінками
recruiting agency - рекрутингове агентство
recession, downturn - економічний спад, криза
white collar job - робота безпосередньо не пов'язана з виробництвом матеріальних благ
sick leave certificate, sick list - лікарняний лист
subordinates, inferious, underling - підлеглі
trainee - стажист
trial period, probation - випробувальний термін
work contract - трудовий договір
work experience - трудовий стаж
work record card - трудова книжка
unemployment - безробіття
unemployment compensation, unemployment benefit - допомога по безробіттю
to apply for a job \ position - подавати заяву про прийом на роботу
to get / land / take a job - отримати роботу, місце
to hire, employ, recruit - наймати на роботу
to hold (down) a job - утримати, не втратити місце
to hunt / look for a job - шукати роботу
to fire, dismiss, sack - звільняти
to give up, quit a job, hand in notice, resign from - звільнитися
to lose a job - втрачати роботу
to make smb redundant
to retire from a job - йти з роботи на пенсію
to be on sick leave - бути на лікарняному
to be on the dole - отримувати допомогу, бути безробітним
to give / provide a reference - давати рекомендацію
to earn, to get - заробляти
to make a career, make one's way up - (с) робити кар'єру
to meet the requirements - відповідати вимогам
to obtain quick promotion - швидко (с) робити кар'єру
to re - train, train for a new profession - перекваліфікуватися
to send one's CV to an employer - послати своє резюме роботодавцю
to take up the job of - влаштуватися на місце
to violate job contract - порушити трудовий договір
to work flexitime - працювати за змінним графіком
salary, wage, pay - заробітна плата
annual salary - річний дохід
fixed salary - фіксована зарплата
remuneration - винагорода
income - дохід
to cut / reduce / slash salaries - урізати, скорочувати зарплату, оклад
to negotiate a salary - домовлятися про зарплату
interview with the personnel director for a job - співбесіда з начальником відділу кадрів при прийомі на роботу
stressed interview - інтерв'ю "під тиском"

# 3 lesson
judge - суддя
route - маршрут
popular holiday destination - популярне у туристів місце
resort - курорт
package holiday - все включено
voyage - морська подорож
vaccinations - щеплення
travel insurance - страхування на час подорожі
passport is expired - термін дії паспорта закінчився
to set off - вирушати в дорогу
flight is delayed\ cancelled - рейс затримується \скасований
one - way ticket - квиток в один кінець
return ticket - квиток туди і назад
departure lounge - зал очікування
shuttle bus - автобус, що курсує по одному і тому ж маршруту з метою доставки пасажирів в потрібне місце, напр, в аеропорт
boarding pass - посадковий талон
jet - реактивний літак
excess baggage - надмірна вага багажу
carry - on luggage - ручна поклажа
aisle seat - місце біля проходу (в літаку)
window seat - місце біля вікна
flight attendant - стюардеса, стюард
anxiety - занепокоєння, тривога
to board (boat / plane) - підніматися на борт (корабля, літака)
to land - приземлятися, робити посадку
to take off - злітати
local currency - місцева валюта
guidebook - путівник
coach - туристичний автобус
sunburn - сонячний опік
to sunbathe засмагати
extreme, unbearable heat - сильна, нестерпна спека
the Mediterranean Sea - Середземне море
the Sea of Azov - Азовське море
the Caribbean Sea - Карибське море
the Dead Sea - мертве море
Cyprus - Кіпр
croatia - Хорватія
overcrowded
solid - твердий
surface - поверхня
reputable - авторитетний
attitude - відношення, ставлення

# 4,5,6 lesson 
adjacent - сусідній
rivalry
Concussion
drug addicted
pep talk
invite
accept - приймати
lonely\loneliness
to unveil - розкривати щось
appealing - той що привертає увагу
consumer - споживач
aimed at - націлений
establish - 
drown - потонути
flask - колба
squished - хлюпався
exchange - обмін
innocent - невинний
rivalry - суперництво
foolproof - надійний

# mr robot 3
despite
vulnerabilities
encumbered
shameful
warm it up
boldness
pumped up
whatever
buzzing
towards
embrace
awake
until
consider
release
blame
stood
obedient
the led all of this
crew
supposed
purse
precisely
wing man
violent
apologize
kiddo
glitch
maze
rip
elusive
fringes
participate
lame
exhilarating
suspicions
apologise
odd
get use to

# mr robot 4
dusting
busting
facilities
tape
security flaw
withdrawal
undivided
crew
lark
urges
unconscious
burns
pees
clarity
rude
smoke weed
casualties
hit
profiteering
enslavement
villains
exorcise
the ray
apology
decongestant
runny
delusion
